###############################
#p     x* *    *   *  * * *   #
#f# # #   # #*#*# # # #*#*#*#*#
#   s     ***  *       *  *   #
#b# # # # #*# # #*#*# # # # #*#
#            **  *  *         #
#b#s#f# # # # # # #*# #*# # # #
#*  *      *  *               #
# # # # #*# # # #*#*# # # # # #
#*    **  *       *           #
# #*# # # # # # #*# # # #*#*#*#
#           *   *  *    *     #
###############################