###############################
#                             #
#           2                 #
#   s     ***  *       *  *   #
#b### # # #*# # #*#*# # # # #*#
#    p       **  *  *         #
#b#s#f# # # # # # #*# #*# # # #
#*  *      *  *               #
# # # # #*# # # #*#*# # # # # #
#*    **  *       *         1 #
# #*# # # # # # #*# # # #*#*#*#
#           *   *  *    *  2  #
###############################